?????????????????????
?????????????????????
???????????.##.....??
??????????vvvvvvvvvvv
?????????#v......??.v
?????????.v.?????????
?????????.v.?????????
?????????.v.?????????
?????????.v.?????????
?????????.v.?????????
?????????.v.?????????
?????????????????????
?????????????????????
?????????????????????
?????????????????????
?????????????????????
?????????????????????
?????????????????????
?????????????????????
?????????????????????
?????????????????????

Robot @ (20, 4) heading SOUTH
